#S##########################################
#..........................................#
#...#####################..#################
###...............########.#################
################.####E####.#################
################...##.####.#################
################.#.##.####.#################
################.#.##.####.#################
################.#..#.####.#################
################.##.#.####.#################
################.##.#.####............######
################.##.#.####.##########.######
################.##.#.####.##########.######
################.##.#.###############.######
################.##.#.####.##########.######
################.##.#.................######
############################################
